1111111110
1P00000001
1000000001
1000000001
1000000001
1000000001
10000P0001
1000000011
1000000E01
1111111111