11111111111
1P1C00100C1
10101C1C101
1C101010101
100C10C01E1
11111111111