1111111111
1000000001
100000E001
1000000001
1000000001
1000000001
100P000001
1000000001
100000C001
1111111111